111111111111111111111111111111111111111111111111112
100000000000000000000000000000000000000000000000012
100000000000000000000000000000000000000000000000012
100000001111100000000000000000000000000000000000012
100000000000000000000000000000000000000000000000012
100000000000000000000000000000000000000000000000012
100000000000000011111110000000000000000000000000012
100000000111111000000000000000000000000000000000012
100000000000000000000000000000000000000000000000012
100000000000000000000000000000000000000000000000012
111000000000000000000000000000000000000000000000012
100000011111100000000000000000000000000000000000012
111111111111111100000000011111111111111111100000012
100000000000000000011111100000000000111111100000012
100000000111111000000000000000000000000000000000012
111111000000000000000000000000000001111110000000012
100000000000000000000001111111111100000111111110012
111111111111111111111111111111111111111111111111113

How to use:
Currently the dimensions of the tiles are 100x100. Therefore each tile is the same dimension as the player.
0s is the background. Non-collidable.
1s are walls and floors. These are collidable. 
2s signal a new line.
3s signal the end of the map.
